***************
*D            *
*             *
*A     GG    A*
***************