****************
*    *    **   *
*D** *   D *   *
*A   ***  D    *
*    *    D    *
*  *    ** A   *
*    *         *
****************