***************
*D    *       *
*     *       *
*A     GG    A*
***************