*******************
*         ** GG   *
* ** *G    *      *
*    ***     ******
*   G*   *  D  *  *
* G*    **     *  *
* G  *GG          *
**** *****  *******
*  *          A   *
*      *GGGGG     *
*******************