*******************
*         **      *
*D** *     *      *
*    ***     ******
*    *   *     *  *
*  *    **     *  *
*    *            *
**** *****  *******
*  *          A   *
*      *          *
*******************