*******************
*         ** GG   *
*D** *G    *      *
*    ***     ******
*   G*   *     *  *
* G*    **     *  *
* G  *GG          *
**** *****  *******
*  *          A   *
*      *GGGGG     *
*******************